id,datetime,counts,weekend_counts,weekday_counts,name
100009426,2014-01-31,1215,271,944,Manhattan Bridge Ped Path
100009428,2014-01-31,27048,4648,22400,Ed Koch Queensboro Bridge Shared Path
100009427,2014-01-31,41692,7292,34400,Williamsburg Bridge Bike Path
100010022,2014-01-31,14579,2033,12546,Brooklyn Bridge Bike Path
100010020,2014-01-31,0,0,0,1st Avenue - 26th St N
100010020,2014-02-28,0,0,0,1st Avenue - 26th St N
100009427,2014-02-28,34168,11454,22714,Williamsburg Bridge Bike Path
100010022,2014-02-28,10504,3702,6802,Brooklyn Bridge Bike Path
100009428,2014-02-28,22048,7133,14915,Ed Koch Queensboro Bridge Shared Path
100009426,2014-02-28,1097,443,654,Manhattan Bridge Ped Path
100010022,2014-03-31,28589,7721,20868,Brooklyn Bridge Bike Path
100009426,2014-03-31,1996,690,1306,Manhattan Bridge Ped Path
100009428,2014-03-31,49185,13779,35406,Ed Koch Queensboro Bridge Shared Path
100009427,2014-03-31,74091,21954,52137,Williamsburg Bridge Bike Path
100010020,2014-03-31,0,0,0,1st Avenue - 26th St N
100009426,2014-04-30,3534,1201,2333,Manhattan Bridge Ped Path
100010022,2014-04-30,63412,18657,44755,Brooklyn Bridge Bike Path
100009427,2014-04-30,134031,37635,96396,Williamsburg Bridge Bike Path
100009428,2014-04-30,89128,24222,64906,Ed Koch Queensboro Bridge Shared Path
100010020,2014-04-30,0,0,0,1st Avenue - 26th St N
100010022,2014-05-31,91028,27547,63481,Brooklyn Bridge Bike Path
100009427,2014-05-31,181715,51274,130441,Williamsburg Bridge Bike Path
100009426,2014-05-31,4584,1568,3016,Manhattan Bridge Ped Path
100010020,2014-05-31,0,0,0,1st Avenue - 26th St N
100009428,2014-05-31,118030,32030,86000,Ed Koch Queensboro Bridge Shared Path
100010022,2014-06-30,95567,29441,66126,Brooklyn Bridge Bike Path
100009427,2014-06-30,200950,57788,143162,Williamsburg Bridge Bike Path
100009428,2014-06-30,133436,38037,95399,Ed Koch Queensboro Bridge Shared Path
100010020,2014-06-30,0,0,0,1st Avenue - 26th St N
100009426,2014-06-30,4840,1623,3217,Manhattan Bridge Ped Path
100009428,2014-07-31,141625,30887,110738,Ed Koch Queensboro Bridge Shared Path
100010022,2014-07-31,94239,23173,71066,Brooklyn Bridge Bike Path
100009426,2014-07-31,5354,1545,3809,Manhattan Bridge Ped Path
100009427,2014-07-31,205069,43961,161108,Williamsburg Bridge Bike Path
100010020,2014-07-31,0,0,0,1st Avenue - 26th St N
100009428,2014-08-31,148298,38980,109318,Ed Koch Queensboro Bridge Shared Path
100009427,2014-08-31,208860,51973,156887,Williamsburg Bridge Bike Path
100010022,2014-08-31,98386,31574,66812,Brooklyn Bridge Bike Path
100010020,2014-08-31,0,0,0,1st Avenue - 26th St N
100009426,2014-08-31,4819,1536,3283,Manhattan Bridge Ped Path
100010022,2014-09-30,40748,9741,31007,Brooklyn Bridge Bike Path
100009428,2014-09-30,139025,30512,108513,Ed Koch Queensboro Bridge Shared Path
100009426,2014-09-30,3607,1005,2602,Manhattan Bridge Ped Path
100009427,2014-09-30,197335,41258,156077,Williamsburg Bridge Bike Path
100010020,2014-09-30,0,0,0,1st Avenue - 26th St N
100010022,2014-10-31,0,0,0,Brooklyn Bridge Bike Path
100009427,2014-10-31,164480,31132,133348,Williamsburg Bridge Bike Path
100009426,2014-10-31,3003,803,2200,Manhattan Bridge Ped Path
100010020,2014-10-31,0,0,0,1st Avenue - 26th St N
100009428,2014-10-31,113054,21478,91576,Ed Koch Queensboro Bridge Shared Path
100010022,2014-11-30,0,0,0,Brooklyn Bridge Bike Path
100009426,2014-11-30,1922,578,1344,Manhattan Bridge Ped Path
100010020,2014-11-30,0,0,0,1st Avenue - 26th St N
100009428,2014-11-30,70169,16903,53266,Ed Koch Queensboro Bridge Shared Path
100009427,2014-11-30,95928,23410,72518,Williamsburg Bridge Bike Path
100009426,2014-12-31,1709,404,1305,Manhattan Bridge Ped Path
100010022,2014-12-31,12763,2140,10623,Brooklyn Bridge Bike Path
100009428,2014-12-31,51348,10116,41232,Ed Koch Queensboro Bridge Shared Path
100009427,2014-12-31,64490,12508,51982,Williamsburg Bridge Bike Path
100010020,2014-12-31,0,0,0,1st Avenue - 26th St N
100009428,2015-01-31,33868,6866,27002,Ed Koch Queensboro Bridge Shared Path
100009426,2015-01-31,1268,303,965,Manhattan Bridge Ped Path
100010022,2015-01-31,14553,2094,12459,Brooklyn Bridge Bike Path
100009427,2015-01-31,42019,7665,34354,Williamsburg Bridge Bike Path
100010020,2015-01-31,0,0,0,1st Avenue - 26th St N
100009426,2015-02-28,870,230,640,Manhattan Bridge Ped Path
100010022,2015-02-28,7744,1466,6278,Brooklyn Bridge Bike Path
100010020,2015-02-28,0,0,0,1st Avenue - 26th St N
100009428,2015-02-28,21352,4749,16603,Ed Koch Queensboro Bridge Shared Path
100009427,2015-02-28,25492,5561,19931,Williamsburg Bridge Bike Path
100010022,2015-03-31,24134,4048,20086,Brooklyn Bridge Bike Path
100009426,2015-03-31,1738,432,1306,Manhattan Bridge Ped Path
100009427,2015-03-31,63096,12563,50533,Williamsburg Bridge Bike Path
100010020,2015-03-31,0,0,0,1st Avenue - 26th St N
100009428,2015-03-31,49686,10212,39474,Ed Koch Queensboro Bridge Shared Path
100010020,2015-04-30,0,0,0,1st Avenue - 26th St N
100010022,2015-04-30,64031,17309,46722,Brooklyn Bridge Bike Path
100009428,2015-04-30,104893,26597,78296,Ed Koch Queensboro Bridge Shared Path
100009427,2015-04-30,151140,41347,109793,Williamsburg Bridge Bike Path
100009426,2015-04-30,3701,1277,2424,Manhattan Bridge Ped Path
100009426,2015-05-31,5380,1856,3524,Manhattan Bridge Ped Path
100009428,2015-05-31,146968,37797,109171,Ed Koch Queensboro Bridge Shared Path
100010020,2015-05-31,69051,33309,35742,1st Avenue - 26th St N
100010022,2015-05-31,104890,30914,73976,Brooklyn Bridge Bike Path
100009427,2015-05-31,219240,62706,156534,Williamsburg Bridge Bike Path
100009426,2015-06-30,5016,1374,3642,Manhattan Bridge Ped Path
100010022,2015-06-30,87135,19280,67855,Brooklyn Bridge Bike Path
100009427,2015-06-30,186583,38151,148432,Williamsburg Bridge Bike Path
100009428,2015-06-30,132678,26483,106195,Ed Koch Queensboro Bridge Shared Path
100010020,2015-06-30,112620,27090,85530,1st Avenue - 26th St N
100009426,2015-07-31,6288,1621,4667,Manhattan Bridge Ped Path
100009428,2015-07-31,148769,29761,119008,Ed Koch Queensboro Bridge Shared Path
100009427,2015-07-31,203547,39083,164464,Williamsburg Bridge Bike Path
100010022,2015-07-31,100783,22616,78167,Brooklyn Bridge Bike Path
100010020,2015-07-31,25505,5676,19829,1st Avenue - 26th St N
100009427,2015-08-31,215483,56606,158877,Williamsburg Bridge Bike Path
100009426,2015-08-31,6831,2369,4462,Manhattan Bridge Ped Path
100010022,2015-08-31,112549,37562,74987,Brooklyn Bridge Bike Path
100009428,2015-08-31,158258,42555,115703,Ed Koch Queensboro Bridge Shared Path
100010020,2015-08-31,40643,14867,25776,1st Avenue - 26th St N
100009428,2015-09-30,148931,31882,117049,Ed Koch Queensboro Bridge Shared Path
100010020,2015-09-30,52810,16775,36035,1st Avenue - 26th St N
100010022,2015-09-30,101477,25678,75799,Brooklyn Bridge Bike Path
100009427,2015-09-30,206019,43455,162564,Williamsburg Bridge Bike Path
100009426,2015-09-30,6027,1666,4361,Manhattan Bridge Ped Path
100009427,2015-10-31,168514,33908,134606,Williamsburg Bridge Bike Path
100010020,2015-10-31,414167,151922,262245,1st Avenue - 26th St N
100009426,2015-10-31,4666,1216,3450,Manhattan Bridge Ped Path
100009428,2015-10-31,120133,24492,95641,Ed Koch Queensboro Bridge Shared Path
100010022,2015-10-31,76984,15415,61569,Brooklyn Bridge Bike Path
100010022,2015-11-30,56371,11722,44649,Brooklyn Bridge Bike Path
100009428,2015-11-30,96541,20828,75713,Ed Koch Queensboro Bridge Shared Path
100009427,2015-11-30,131344,29501,101843,Williamsburg Bridge Bike Path
100010020,2015-11-30,750459,262895,487564,1st Avenue - 26th St N
100009426,2015-11-30,3564,979,2585,Manhattan Bridge Ped Path
100010022,2015-12-31,41299,8607,32692,Brooklyn Bridge Bike Path
100009427,2015-12-31,97191,21596,75595,Williamsburg Bridge Bike Path
100010020,2015-12-31,930480,253385,677095,1st Avenue - 26th St N
100009426,2015-12-31,2948,787,2161,Manhattan Bridge Ped Path
100009428,2015-12-31,75367,16695,58672,Ed Koch Queensboro Bridge Shared Path
100009428,2016-01-31,48548,11508,37040,Ed Koch Queensboro Bridge Shared Path
100010020,2016-01-31,1155453,287759,867694,1st Avenue - 26th St N
100009426,2016-01-31,1982,665,1317,Manhattan Bridge Ped Path
100010022,2016-01-31,23112,4827,18285,Brooklyn Bridge Bike Path
100009427,2016-01-31,60899,14931,45968,Williamsburg Bridge Bike Path
100009428,2016-02-29,53096,12391,40705,Ed Koch Queensboro Bridge Shared Path
100010020,2016-02-29,1121975,330590,791385,1st Avenue - 26th St N
100009427,2016-02-29,64731,16802,47929,Williamsburg Bridge Bike Path
100009426,2016-02-29,1960,608,1352,Manhattan Bridge Ped Path
100010022,2016-02-29,25328,5927,19401,Brooklyn Bridge Bike Path
100009427,2016-03-31,127931,23820,104111,Williamsburg Bridge Bike Path
100009428,2016-03-31,95096,18411,76685,Ed Koch Queensboro Bridge Shared Path
100010020,2016-03-31,654848,205645,449203,1st Avenue - 26th St N
100009426,2016-03-31,3581,850,2731,Manhattan Bridge Ped Path
100010022,2016-03-31,57882,10322,47560,Brooklyn Bridge Bike Path
100009426,2016-04-30,4572,1391,3181,Manhattan Bridge Ped Path
100009428,2016-04-30,100727,26220,74507,Ed Koch Queensboro Bridge Shared Path
100010022,2016-04-30,68162,16871,51291,Brooklyn Bridge Bike Path
100009427,2016-04-30,145919,35619,110300,Williamsburg Bridge Bike Path
100010020,2016-04-30,338467,79303,259164,1st Avenue - 26th St N
100010022,2016-05-31,84445,20141,64304,Brooklyn Bridge Bike Path
100009426,2016-05-31,5310,1572,3738,Manhattan Bridge Ped Path
100009428,2016-05-31,118397,26761,91636,Ed Koch Queensboro Bridge Shared Path
100009427,2016-05-31,173626,36623,137003,Williamsburg Bridge Bike Path
100010020,2016-05-31,0,0,0,1st Avenue - 26th St N
100009428,2016-06-30,144470,30763,113707,Ed Koch Queensboro Bridge Shared Path
100009427,2016-06-30,218633,42500,176133,Williamsburg Bridge Bike Path
100009426,2016-06-30,6116,1606,4510,Manhattan Bridge Ped Path
100010022,2016-06-30,108420,24473,83947,Brooklyn Bridge Bike Path
100010020,2016-06-30,0,0,0,1st Avenue - 26th St N
100010020,2016-07-31,0,0,0,1st Avenue - 26th St N
100010022,2016-07-31,114948,30272,84676,Brooklyn Bridge Bike Path
100009427,2016-07-31,194781,45884,148897,Williamsburg Bridge Bike Path
100009428,2016-07-31,144802,35321,109481,Ed Koch Queensboro Bridge Shared Path
100009426,2016-07-31,6274,1956,4318,Manhattan Bridge Ped Path
100009426,2016-08-31,6702,1571,5131,Manhattan Bridge Ped Path
100010022,2016-08-31,106064,24907,81157,Brooklyn Bridge Bike Path
100009427,2016-08-31,211541,37221,174320,Williamsburg Bridge Bike Path
100010020,2016-08-31,95840,18497,77343,1st Avenue - 26th St N
100009428,2016-08-31,157072,29661,127411,Ed Koch Queensboro Bridge Shared Path
100009426,2016-09-30,6338,1781,4557,Manhattan Bridge Ped Path
100009428,2016-09-30,140462,30939,109523,Ed Koch Queensboro Bridge Shared Path
100010020,2016-09-30,120039,20128,99911,1st Avenue - 26th St N
100009427,2016-09-30,197796,43646,154150,Williamsburg Bridge Bike Path
100010022,2016-09-30,90578,24300,66278,Brooklyn Bridge Bike Path
100009426,2016-10-31,5026,1423,3603,Manhattan Bridge Ped Path
100009428,2016-10-31,114568,25721,88847,Ed Koch Queensboro Bridge Shared Path
100009427,2016-10-31,176085,36794,139291,Williamsburg Bridge Bike Path
100010020,2016-10-31,90852,17803,73049,1st Avenue - 26th St N
100010022,2016-10-31,76119,15488,60631,Brooklyn Bridge Bike Path
100010020,2016-11-30,61812,13595,48217,1st Avenue - 26th St N
100009428,2016-11-30,93395,18184,75211,Ed Koch Queensboro Bridge Shared Path
100010022,2016-11-30,52485,10795,41690,Brooklyn Bridge Bike Path
100009427,2016-11-30,127524,26758,100766,Williamsburg Bridge Bike Path
100009426,2016-11-30,4036,1007,3029,Manhattan Bridge Ped Path
100009427,2016-12-31,76939,13936,63003,Williamsburg Bridge Bike Path
100009428,2016-12-31,63458,11432,52026,Ed Koch Queensboro Bridge Shared Path
100010020,2016-12-31,53056,11557,41499,1st Avenue - 26th St N
100010022,2016-12-31,28375,4411,23964,Brooklyn Bridge Bike Path
100009426,2016-12-31,2993,690,2303,Manhattan Bridge Ped Path
100009426,2017-01-31,2649,715,1934,Manhattan Bridge Ped Path
100010022,2017-01-31,23668,3964,19704,Brooklyn Bridge Bike Path
100009428,2017-01-31,55682,11338,44344,Ed Koch Queensboro Bridge Shared Path
100009425,2017-01-31,32039,8179,23860,Prospect Park West
100010017,2017-01-31,7812,1569,6243,Staten Island Ferry
100009427,2017-01-31,69271,13895,55376,Williamsburg Bridge Bike Path
100010020,2017-01-31,48183,10043,38140,1st Avenue - 26th St N
100010019,2017-01-31,32010,7501,24509,Kent Avenue Bike Path
100009428,2017-02-28,61319,13525,47794,Ed Koch Queensboro Bridge Shared Path
100009426,2017-02-28,3156,852,2304,Manhattan Bridge Ped Path
100010017,2017-02-28,8261,1829,6432,Staten Island Ferry
100010022,2017-02-28,31332,6328,25004,Brooklyn Bridge Bike Path
100010020,2017-02-28,48960,10041,38919,1st Avenue - 26th St N
100009425,2017-02-28,36430,10445,25985,Prospect Park West
100009427,2017-02-28,83716,18308,65408,Williamsburg Bridge Bike Path
100010019,2017-02-28,40789,11819,28970,Kent Avenue Bike Path
100010017,2017-03-31,7572,1302,6270,Staten Island Ferry
100010020,2017-03-31,45261,8568,36693,1st Avenue - 26th St N
100009428,2017-03-31,54010,9880,44130,Ed Koch Queensboro Bridge Shared Path
100010022,2017-03-31,27568,3605,23963,Brooklyn Bridge Bike Path
100009426,2017-03-31,2725,556,2169,Manhattan Bridge Ped Path
100010019,2017-03-31,34977,7029,27948,Kent Avenue Bike Path
100009425,2017-03-31,35263,8073,27190,Prospect Park West
100009427,2017-03-31,73559,11901,61658,Williamsburg Bridge Bike Path
100010022,2017-04-30,67518,21144,46374,Brooklyn Bridge Bike Path
100010020,2017-04-30,69362,18190,51172,1st Avenue - 26th St N
100010017,2017-04-30,12834,4318,8516,Staten Island Ferry
100009428,2017-04-30,104495,29982,74513,Ed Koch Queensboro Bridge Shared Path
100009426,2017-04-30,5392,1936,3456,Manhattan Bridge Ped Path
100010019,2017-04-30,80899,32839,48060,Kent Avenue Bike Path
100009425,2017-04-30,63343,26266,37077,Prospect Park West
100009427,2017-04-30,148359,43382,104977,Williamsburg Bridge Bike Path
100010017,2017-05-31,14770,3390,11380,Staten Island Ferry
100010022,2017-05-31,76022,16953,59069,Brooklyn Bridge Bike Path
100009427,2017-05-31,177159,36461,140698,Williamsburg Bridge Bike Path
100009425,2017-05-31,68620,19036,49584,Prospect Park West
100010019,2017-05-31,93551,28295,65256,Kent Avenue Bike Path
100009428,2017-05-31,126467,25452,101015,Ed Koch Queensboro Bridge Shared Path
100009426,2017-05-31,6078,1381,4697,Manhattan Bridge Ped Path
100010020,2017-05-31,92779,13962,78817,1st Avenue - 26th St N
100010019,2017-06-30,112507,32628,79879,Kent Avenue Bike Path
100009426,2017-06-30,6707,1746,4961,Manhattan Bridge Ped Path
100009425,2017-06-30,83533,24348,59185,Prospect Park West
100009427,2017-06-30,198781,40176,158605,Williamsburg Bridge Bike Path
100010022,2017-06-30,82728,18337,64391,Brooklyn Bridge Bike Path
100009428,2017-06-30,141925,28287,113638,Ed Koch Queensboro Bridge Shared Path
100010017,2017-06-30,16027,3417,12610,Staten Island Ferry
100010020,2017-06-30,111310,18546,92764,1st Avenue - 26th St N
100010022,2017-07-31,85417,25752,59665,Brooklyn Bridge Bike Path
100009426,2017-07-31,7469,2438,5031,Manhattan Bridge Ped Path
100009428,2017-07-31,141250,37988,103262,Ed Koch Queensboro Bridge Shared Path
100010020,2017-07-31,101203,22658,78545,1st Avenue - 26th St N
100009427,2017-07-31,188090,49361,138729,Williamsburg Bridge Bike Path
100009425,2017-07-31,85501,29403,56098,Prospect Park West
100010019,2017-07-31,114776,40933,73843,Kent Avenue Bike Path
100010017,2017-07-31,17025,4989,12036,Staten Island Ferry
100010020,2017-08-31,106501,18420,88081,1st Avenue - 26th St N
100010019,2017-08-31,112560,32687,79873,Kent Avenue Bike Path
100009428,2017-08-31,160299,34826,125473,Ed Koch Queensboro Bridge Shared Path
100010022,2017-08-31,94877,26795,68082,Brooklyn Bridge Bike Path
100009427,2017-08-31,198658,42538,156120,Williamsburg Bridge Bike Path
100009426,2017-08-31,7994,2470,5524,Manhattan Bridge Ped Path
100009425,2017-08-31,81250,24288,56962,Prospect Park West
100010017,2017-08-31,17962,4353,13609,Staten Island Ferry
100010020,2017-09-30,100876,19300,81576,1st Avenue - 26th St N
100009425,2017-09-30,82350,26930,55420,Prospect Park West
100010019,2017-09-30,113152,36368,76784,Kent Avenue Bike Path
100010017,2017-09-30,15398,4033,11365,Staten Island Ferry
100009428,2017-09-30,151610,34345,117265,Ed Koch Queensboro Bridge Shared Path
100009426,2017-09-30,7422,2162,5260,Manhattan Bridge Ped Path
100009427,2017-09-30,198404,43963,154441,Williamsburg Bridge Bike Path
100010022,2017-09-30,86869,22819,64050,Brooklyn Bridge Bike Path
100010020,2017-10-31,102604,19616,82988,1st Avenue - 26th St N
100009428,2017-10-31,147909,32281,115628,Ed Koch Queensboro Bridge Shared Path
100010019,2017-10-31,95945,28981,66964,Kent Avenue Bike Path
100010022,2017-10-31,80113,18056,62057,Brooklyn Bridge Bike Path
100010017,2017-10-31,13412,3528,9884,Staten Island Ferry
100009425,2017-10-31,77003,24186,52817,Prospect Park West
100009426,2017-10-31,7515,2020,5495,Manhattan Bridge Ped Path
100009427,2017-10-31,185745,40347,145398,Williamsburg Bridge Bike Path
100009426,2017-11-30,4433,990,3443,Manhattan Bridge Ped Path
100009425,2017-11-30,55561,14296,41265,Prospect Park West
100010022,2017-11-30,46532,7542,38990,Brooklyn Bridge Bike Path
100010017,2017-11-30,9803,2047,7756,Staten Island Ferry
100010019,2017-11-30,59370,13443,45927,Kent Avenue Bike Path
100009428,2017-11-30,100398,17187,83211,Ed Koch Queensboro Bridge Shared Path
100009427,2017-11-30,122012,21788,100224,Williamsburg Bridge Bike Path
100010020,2017-11-30,63410,12087,51323,1st Avenue - 26th St N
100010019,2017-12-31,37439,9318,28121,Kent Avenue Bike Path
100009426,2017-12-31,2900,720,2180,Manhattan Bridge Ped Path
100010022,2017-12-31,27517,4108,23409,Brooklyn Bridge Bike Path
100009427,2017-12-31,73484,13450,60034,Williamsburg Bridge Bike Path
100009425,2017-12-31,39099,10468,28631,Prospect Park West
100009428,2017-12-31,71533,13640,57893,Ed Koch Queensboro Bridge Shared Path
100010017,2017-12-31,7387,1671,5716,Staten Island Ferry
100010020,2017-12-31,43661,9515,34146,1st Avenue - 26th St N
100009428,2018-01-31,49528,10412,39116,Ed Koch Queensboro Bridge Shared Path
100010018,2018-01-31,21246,4961,16285,Pulaski Bridge
100009427,2018-01-31,56600,11794,44806,Williamsburg Bridge Bike Path
100009425,2018-01-31,32889,9059,23830,Prospect Park West
100009426,2018-01-31,2469,638,1831,Manhattan Bridge Ped Path
100010020,2018-01-31,34543,7443,27100,1st Avenue - 26th St N
100010017,2018-01-31,6206,1347,4859,Staten Island Ferry
100010022,2018-01-31,20525,3434,17091,Brooklyn Bridge Bike Path
100010019,2018-01-31,29307,7728,21579,Kent Avenue Bike Path
100010018,2018-02-28,26802,4387,22415,Pulaski Bridge
100009426,2018-02-28,3146,651,2495,Manhattan Bridge Ped Path
100010022,2018-02-28,28776,2934,25842,Brooklyn Bridge Bike Path
100010020,2018-02-28,40546,7138,33408,1st Avenue - 26th St N
100009427,2018-02-28,72110,9786,62324,Williamsburg Bridge Bike Path
100009425,2018-02-28,36569,8201,28368,Prospect Park West
100010019,2018-02-28,36375,6281,30094,Kent Avenue Bike Path
100009428,2018-02-28,58369,8310,50059,Ed Koch Queensboro Bridge Shared Path
100010017,2018-02-28,6656,1209,5447,Staten Island Ferry
100010018,2018-03-31,30530,9132,21398,Pulaski Bridge
100010022,2018-03-31,31311,7253,24058,Brooklyn Bridge Bike Path
100010020,2018-03-31,45243,11632,33611,1st Avenue - 26th St N
100009428,2018-03-31,64309,16397,47912,Ed Koch Queensboro Bridge Shared Path
100010017,2018-03-31,6978,1856,5122,Staten Island Ferry
100009425,2018-03-31,42969,14769,28200,Prospect Park West
100010019,2018-03-31,40898,13559,27339,Kent Avenue Bike Path
100009426,2018-03-31,3466,1205,2261,Manhattan Bridge Ped Path
100009427,2018-03-31,80244,20722,59522,Williamsburg Bridge Bike Path
100009426,2018-04-30,4639,1574,3065,Manhattan Bridge Ped Path
100009425,2018-04-30,58473,22386,36087,Prospect Park West
100010017,2018-04-30,9700,3258,6442,Staten Island Ferry
100009427,2018-04-30,117491,33209,84282,Williamsburg Bridge Bike Path
100010018,2018-04-30,43041,14888,28153,Pulaski Bridge
100010022,2018-04-30,51769,15757,36012,Brooklyn Bridge Bike Path
100010020,2018-04-30,57432,14967,42465,1st Avenue - 26th St N
100010019,2018-04-30,66346,26373,39973,Kent Avenue Bike Path
100009428,2018-04-30,89915,25004,64911,Ed Koch Queensboro Bridge Shared Path
100009425,2018-05-31,74643,16589,58054,Prospect Park West
100009427,2018-05-31,180084,25437,154647,Williamsburg Bridge Bike Path
100010022,2018-05-31,88888,15300,73588,Brooklyn Bridge Bike Path
100010017,2018-05-31,12762,2509,10253,Staten Island Ferry
100009428,2018-05-31,135071,19471,115600,Ed Koch Queensboro Bridge Shared Path
100009426,2018-05-31,6674,1424,5250,Manhattan Bridge Ped Path
100010019,2018-05-31,98194,22672,75522,Kent Avenue Bike Path
100010020,2018-05-31,93858,13474,80384,1st Avenue - 26th St N
100010018,2018-05-31,61451,10581,50870,Pulaski Bridge
100010017,2018-06-30,13585,3504,10081,Staten Island Ferry
100009428,2018-06-30,144092,32226,111866,Ed Koch Queensboro Bridge Shared Path
100009426,2018-06-30,7940,2842,5098,Manhattan Bridge Ped Path
100010020,2018-06-30,91873,18132,73741,1st Avenue - 26th St N
100009427,2018-06-30,192324,41391,150933,Williamsburg Bridge Bike Path
100010019,2018-06-30,109333,33437,75896,Kent Avenue Bike Path
100009425,2018-06-30,83958,27652,56306,Prospect Park West
100010022,2018-06-30,84047,19314,64733,Brooklyn Bridge Bike Path
100010018,2018-06-30,67319,18294,49025,Pulaski Bridge
100009426,2018-07-31,7005,2012,4993,Manhattan Bridge Ped Path
100009428,2018-07-31,140044,32107,107937,Ed Koch Queensboro Bridge Shared Path
100010017,2018-07-31,14349,3885,10464,Staten Island Ferry
100009427,2018-07-31,180935,41234,139701,Williamsburg Bridge Bike Path
100009425,2018-07-31,84075,26599,57476,Prospect Park West
100010019,2018-07-31,107743,34820,72923,Kent Avenue Bike Path
100010020,2018-07-31,96809,18702,78107,1st Avenue - 26th St N
100010022,2018-07-31,85581,22369,63212,Brooklyn Bridge Bike Path
100010018,2018-07-31,67830,20250,47580,Pulaski Bridge
100010020,2018-08-31,98615,16978,81637,1st Avenue - 26th St N
100009426,2018-08-31,6395,1530,4865,Manhattan Bridge Ped Path
100009425,2018-08-31,77449,19552,57897,Prospect Park West
100009428,2018-08-31,140294,26215,114079,Ed Koch Queensboro Bridge Shared Path
100010022,2018-08-31,89839,20733,69106,Brooklyn Bridge Bike Path
100010019,2018-08-31,100440,25175,75265,Kent Avenue Bike Path
100010017,2018-08-31,13900,3045,10855,Staten Island Ferry
100009427,2018-08-31,183377,34096,149281,Williamsburg Bridge Bike Path
100010018,2018-08-31,65686,15213,50473,Pulaski Bridge
100009428,2018-09-30,120646,35373,85273,Ed Koch Queensboro Bridge Shared Path
100010017,2018-09-30,12896,4348,8548,Staten Island Ferry
100010019,2018-09-30,93066,37869,55197,Kent Avenue Bike Path
100009427,2018-09-30,161792,47076,114716,Williamsburg Bridge Bike Path
100009426,2018-09-30,6009,2117,3892,Manhattan Bridge Ped Path
100010020,2018-09-30,90373,21979,68394,1st Avenue - 26th St N
100010022,2018-09-30,74136,24953,49183,Brooklyn Bridge Bike Path
100009425,2018-09-30,75345,29687,45658,Prospect Park West
100010018,2018-09-30,62602,24400,38202,Pulaski Bridge
100010017,2018-10-31,12500,2462,10038,Staten Island Ferry
100009428,2018-10-31,122132,21048,101084,Ed Koch Queensboro Bridge Shared Path
100009425,2018-10-31,71307,17176,54131,Prospect Park West
100009427,2018-10-31,170737,31732,139005,Williamsburg Bridge Bike Path
100010020,2018-10-31,86259,15156,71103,1st Avenue - 26th St N
100010022,2018-10-31,68900,11594,57306,Brooklyn Bridge Bike Path
100009426,2018-10-31,5492,1250,4242,Manhattan Bridge Ped Path
100010018,2018-10-31,57309,11953,45356,Pulaski Bridge
100010019,2018-10-31,81621,18760,62861,Kent Avenue Bike Path
100010018,2018-11-30,34977,8752,26225,Pulaski Bridge
100010020,2018-11-30,56284,12626,43658,1st Avenue - 26th St N
100009426,2018-11-30,3626,981,2645,Manhattan Bridge Ped Path
100010019,2018-11-30,47330,13355,33975,Kent Avenue Bike Path
100010022,2018-11-30,33803,7399,26404,Brooklyn Bridge Bike Path
100009428,2018-11-30,76149,15732,60417,Ed Koch Queensboro Bridge Shared Path
100009427,2018-11-30,99727,23666,76061,Williamsburg Bridge Bike Path
100009425,2018-11-30,51478,15057,36421,Prospect Park West
100010017,2018-11-30,8691,1939,6752,Staten Island Ferry
100010017,2018-12-31,7632,2035,5597,Staten Island Ferry
100010020,2018-12-31,47288,11466,35822,1st Avenue - 26th St N
100009426,2018-12-31,2983,884,2099,Manhattan Bridge Ped Path
100010022,2018-12-31,23345,4374,18971,Brooklyn Bridge Bike Path
100009428,2018-12-31,62026,14852,47174,Ed Koch Queensboro Bridge Shared Path
100009427,2018-12-31,73597,17525,56072,Williamsburg Bridge Bike Path
100010019,2018-12-31,36006,10860,25146,Kent Avenue Bike Path
100009425,2018-12-31,43075,13463,29612,Prospect Park West
100010018,2018-12-31,28505,7713,20792,Pulaski Bridge
100010020,2019-01-31,44449,8775,35674,1st Avenue - 26th St N
100057316,2019-01-31,0,0,0,8th Ave at 50th St.
100009425,2019-01-31,41954,10425,31529,Prospect Park West
100009426,2019-01-31,2404,539,1865,Manhattan Bridge Ped Path
100009428,2019-01-31,55895,10357,45538,Ed Koch Queensboro Bridge Shared Path
100010018,2019-01-31,26455,5486,20969,Pulaski Bridge
100010019,2019-01-31,32965,7968,24997,Kent Avenue Bike Path
100047029,2019-01-31,59413,9499,49914,Manhattan Bridge Display Bike Counter
100010022,2019-01-31,20859,2727,18132,Brooklyn Bridge Bike Path
100010017,2019-01-31,7144,1373,5771,Staten Island Ferry
100009427,2019-01-31,68047,12246,55801,Williamsburg Bridge Bike Path
100010017,2019-02-28,6739,1475,5264,Staten Island Ferry
100010019,2019-02-28,34530,9411,25119,Kent Avenue Bike Path
100009425,2019-02-28,38666,11285,27381,Prospect Park West
100010018,2019-02-28,26306,6492,19814,Pulaski Bridge
100010020,2019-02-28,42942,9583,33359,1st Avenue - 26th St N
100009427,2019-02-28,71462,16493,54969,Williamsburg Bridge Bike Path
100009428,2019-02-28,54777,11777,43000,Ed Koch Queensboro Bridge Shared Path
100009426,2019-02-28,2563,650,1913,Manhattan Bridge Ped Path
100057316,2019-02-28,0,0,0,8th Ave at 50th St.
100010022,2019-02-28,20571,3342,17229,Brooklyn Bridge Bike Path
100047029,2019-02-28,57267,10883,46384,Manhattan Bridge Display Bike Counter
100057316,2019-03-31,0,0,0,8th Ave at 50th St.
100009425,2019-03-31,50691,17123,33568,Prospect Park West
100009427,2019-03-31,99802,28084,71718,Williamsburg Bridge Bike Path
100010018,2019-03-31,36447,11497,24950,Pulaski Bridge
100047029,2019-03-31,83463,19958,63505,Manhattan Bridge Display Bike Counter
100009428,2019-03-31,73808,19035,54773,Ed Koch Queensboro Bridge Shared Path
100009426,2019-03-31,3539,1179,2360,Manhattan Bridge Ped Path
100010019,2019-03-31,49935,17512,32423,Kent Avenue Bike Path
100010020,2019-03-31,54710,14663,40047,1st Avenue - 26th St N
100010017,2019-03-31,8142,2090,6052,Staten Island Ferry
100010022,2019-03-31,30481,7148,23333,Brooklyn Bridge Bike Path
100010018,2019-04-30,52402,15430,36972,Pulaski Bridge
100009426,2019-04-30,5198,1433,3765,Manhattan Bridge Ped Path
100010022,2019-04-30,57172,12945,44227,Brooklyn Bridge Bike Path
100009425,2019-04-30,67085,21341,45744,Prospect Park West
100009428,2019-04-30,103877,23347,80530,Ed Koch Queensboro Bridge Shared Path
100047029,2019-04-30,129441,27094,102347,Manhattan Bridge Display Bike Counter
100009427,2019-04-30,146807,34350,112457,Williamsburg Bridge Bike Path
100057316,2019-04-30,0,0,0,8th Ave at 50th St.
100010017,2019-04-30,10882,2773,8109,Staten Island Ferry
100010020,2019-04-30,74476,15971,58505,1st Avenue - 26th St N
100010019,2019-04-30,76026,25711,50315,Kent Avenue Bike Path
100010020,2019-05-31,84212,15594,68618,1st Avenue - 26th St N
100009427,2019-05-31,171246,35085,136161,Williamsburg Bridge Bike Path
100010019,2019-05-31,92881,28043,64838,Kent Avenue Bike Path
100009428,2019-05-31,119263,23244,96019,Ed Koch Queensboro Bridge Shared Path
100057316,2019-05-31,0,0,0,8th Ave at 50th St.
100010018,2019-05-31,59392,14517,44875,Pulaski Bridge
100009426,2019-05-31,5911,1442,4469,Manhattan Bridge Ped Path
100009425,2019-05-31,77645,21413,56232,Prospect Park West
100047029,2019-05-31,134064,23516,110548,Manhattan Bridge Display Bike Counter
100010022,2019-05-31,62326,13298,49028,Brooklyn Bridge Bike Path
100010017,2019-05-31,12780,2875,9905,Staten Island Ferry
100047029,2019-06-30,136963,38718,98245,Manhattan Bridge Display Bike Counter
100010018,2019-06-30,65756,25150,40606,Pulaski Bridge
100009426,2019-06-30,6496,2342,4154,Manhattan Bridge Ped Path
100010020,2019-06-30,31791,9317,22474,1st Avenue - 26th St N
100009428,2019-06-30,125571,38558,87013,Ed Koch Queensboro Bridge Shared Path
100009427,2019-06-30,185716,58013,127703,Williamsburg Bridge Bike Path
100010022,2019-06-30,63133,20249,42884,Brooklyn Bridge Bike Path
100010017,2019-06-30,13138,4324,8814,Staten Island Ferry
100057316,2019-06-30,78276,34807,43469,8th Ave at 50th St.
100009425,2019-06-30,91040,36925,54115,Prospect Park West
100010019,2019-06-30,103258,41981,61277,Kent Avenue Bike Path
100047029,2019-07-31,143530,26628,116902,Manhattan Bridge Display Bike Counter
100009427,2019-07-31,184614,37396,147218,Williamsburg Bridge Bike Path
100010020,2019-07-31,0,0,0,1st Avenue - 26th St N
100009428,2019-07-31,135949,27438,108511,Ed Koch Queensboro Bridge Shared Path
100010017,2019-07-31,13811,3294,10517,Staten Island Ferry
100057316,2019-07-31,375692,113347,262345,8th Ave at 50th St.
100009426,2019-07-31,6945,1703,5242,Manhattan Bridge Ped Path
100009425,2019-07-31,83462,22202,61260,Prospect Park West
100010019,2019-07-31,99663,26804,72859,Kent Avenue Bike Path
100010022,2019-07-31,66634,14803,51831,Brooklyn Bridge Bike Path
100010018,2019-07-31,64223,15490,48733,Pulaski Bridge
100009428,2019-08-31,144003,35411,108592,Ed Koch Queensboro Bridge Shared Path
100057316,2019-08-31,119755,30434,89321,8th Ave at 50th St.
100010020,2019-08-31,0,0,0,1st Avenue - 26th St N
100010017,2019-08-31,14868,4407,10461,Staten Island Ferry
100047029,2019-08-31,153675,35860,117815,Manhattan Bridge Display Bike Counter
100010022,2019-08-31,76513,23127,53386,Brooklyn Bridge Bike Path
100009426,2019-08-31,7056,2170,4886,Manhattan Bridge Ped Path
100009427,2019-08-31,199009,49328,149681,Williamsburg Bridge Bike Path
100010019,2019-08-31,106754,35213,71541,Kent Avenue Bike Path
100010018,2019-08-31,68244,20089,48155,Pulaski Bridge
100009425,2019-08-31,84881,28066,56815,Prospect Park West
100010017,2019-09-30,13951,4034,9917,Staten Island Ferry
100009425,2019-09-30,88917,32833,56084,Prospect Park West
100009426,2019-09-30,6909,2071,4838,Manhattan Bridge Ped Path
100009427,2019-09-30,207790,54230,153560,Williamsburg Bridge Bike Path
100047029,2019-09-30,160758,38222,122536,Manhattan Bridge Display Bike Counter
100010020,2019-09-30,0,0,0,1st Avenue - 26th St N
100057316,2019-09-30,94588,27265,67323,8th Ave at 50th St.
100010018,2019-09-30,72399,23366,49033,Pulaski Bridge
100010022,2019-09-30,71794,20115,51679,Brooklyn Bridge Bike Path
100010019,2019-09-30,105192,36504,68688,Kent Avenue Bike Path
100009428,2019-09-30,141060,34230,106830,Ed Koch Queensboro Bridge Shared Path
100010020,2019-10-31,0,0,0,1st Avenue - 26th St N
100009427,2019-10-31,163751,33860,129891,Williamsburg Bridge Bike Path
100010017,2019-10-31,11674,2730,8944,Staten Island Ferry
100047029,2019-10-31,129677,23885,105792,Manhattan Bridge Display Bike Counter
100009425,2019-10-31,72341,20619,51722,Prospect Park West
100057316,2019-10-31,85883,20012,65871,8th Ave at 50th St.
100010019,2019-10-31,76984,20606,56378,Kent Avenue Bike Path
100010022,2019-10-31,54997,10186,44811,Brooklyn Bridge Bike Path
100010018,2019-10-31,55042,13149,41893,Pulaski Bridge
100009428,2019-10-31,116161,23506,92655,Ed Koch Queensboro Bridge Shared Path
100009426,2019-10-31,5153,1212,3941,Manhattan Bridge Ped Path
100010022,2019-11-30,32878,5594,27284,Brooklyn Bridge Bike Path
100047029,2019-11-30,92166,18291,73875,Manhattan Bridge Display Bike Counter
100009428,2019-11-30,84128,16882,67246,Ed Koch Queensboro Bridge Shared Path
100010020,2019-11-30,0,0,0,1st Avenue - 26th St N
100009426,2019-11-30,3382,907,2475,Manhattan Bridge Ped Path
100010017,2019-11-30,9584,2410,7174,Staten Island Ferry
100009427,2019-11-30,113871,25888,87983,Williamsburg Bridge Bike Path
100057316,2019-11-30,68708,17834,50874,8th Ave at 50th St.
100010018,2019-11-30,37155,8724,28431,Pulaski Bridge
100010019,2019-11-30,51940,14598,37342,Kent Avenue Bike Path
100009425,2019-11-30,58155,18120,40035,Prospect Park West
100010018,2019-12-31,22734,5919,16815,Pulaski Bridge
100010020,2019-12-31,0,0,0,1st Avenue - 26th St N
100010022,2019-12-31,16149,2936,13213,Brooklyn Bridge Bike Path
100010019,2019-12-31,35149,10262,24887,Kent Avenue Bike Path
100057316,2019-12-31,75841,20783,55058,8th Ave at 50th St.
100009425,2019-12-31,41080,12978,28102,Prospect Park West
100009427,2019-12-31,66817,16948,49869,Williamsburg Bridge Bike Path
100047029,2019-12-31,51480,12064,39416,Manhattan Bridge Display Bike Counter
100009426,2019-12-31,2386,690,1696,Manhattan Bridge Ped Path
100009428,2019-12-31,57951,13667,44284,Ed Koch Queensboro Bridge Shared Path
100010017,2019-12-31,7096,1801,5295,Staten Island Ferry
